bombs:3
        #       |
  #             |
       #  ###   |
             #  |
              # |
       ####     |
     ##        #|
S  ####  ##   ##|
################|