bombs:3
                |
    ~  __  ~    |
       __       |
      ~~~~      |
                |
   ####~~  ##   |
     __~~__     |
    S__~~__     |
   ##########   |
