bombs:3
    _           |
    _           |
    _           |
    # XX        |
    #           |
    ____##XX _  |
        #    _  |
    S   ____####|
    ############|