bombs:10
                |
~~~_~~~~~~~~~~~~|
~~~_#######~~~~~|
~~~_       __~~~|
~~~_##   ##~_~~~|
~~~_##XXX##~_~~~|
~~~_#~~~~~~~_~~~|
~~~##S~~~~~~_~~~|
################|