bombs:5
      XXXXXXXXXX|
 #              |
   #            |
     #     X _  |
XXXXXXXXX       |
    X        #  |
          #     |
   #S  #        |
    #           |