bombs:7
                |
~~  ~~~~~~~~~~~~|
     #          |
     #          |
  ~~~~~~~~~~    |
       #        |
########        |
       S        |
     ~~~~~~~    |