bombs:5
                |
  X_  XX X_     |
   _ X      _X  |
   _            |
 X     X    X   |
    X_          |
            _   |
 X    S_    X   |
    ########    |