bombs:5
      XXXXXXXXXX|
 #              |
   #            |
     #         |
XXXXXXXXX  X _  |
    X        #  |
          #     |
   #S  #        |
    #           |