                |
   ~        ~   |
                |
~              ~|
                |
    ~~    ~~    |
     X    X     |
       S        |
##    ####    ##|