bombs:3
                |
###          ###|
      ####      |
                |
                |
   ###    ___   |
         ___    |
    S   ___     |
################|
