bombs:15
                |
###    ___   ###|
###   ___       |
###   ##########|
                |
   ###____      |
        ___     |
    S  ___      |
################|
