bombs:3
                |
   ~        ~   |
                |
~_            _~|
                |
    ~~    ~~    |
     X __ X     |
     X S  X     |
     ######     |