bombs:5
X  X  X  XXXXXXX|
XXXX  XXX#      |
                |
         #      |
##########  ____|
                |
____#########__#|
      S         |
   _########    |